"at" = (/obj/structure/shuttle/part/dropship2/lower_right_wall,/turf/open/space/basic,/area/shuttle/drop2/sulaco)
"bk" = (/turf/closed/shuttle/dropship2/transparent{icon_state = "23"},/area/shuttle/drop2/sulaco)
"bF" = (/obj/effect/attach_point/crew_weapon/dropship2,/obj/effect/decal/warning_stripes,/obj/docking_port/mobile/marine_dropship/attu,/turf/open/shuttle/dropship{icon_state = "rasputin15"},/area/shuttle/drop2/sulaco)
"bV" = (/turf/closed/shuttle/dropship2{icon_state = "31"},/area/shuttle/drop2/sulaco)
"cF" = (/obj/effect/decal/warning_stripes{icon_state = "W"},/turf/open/shuttle/dropship{icon_state = "rasputin3"},/area/shuttle/drop2/sulaco)
"cM" = (/obj/structure/machinery/door/airlock/dropship_hatch/two{dir = 8; id = "starboard_door"},/obj/structure/stairs{dir = 4},/obj/structure/blocker/forcefield/multitile_vehicles,/turf/open/shuttle/dropship{icon_state = "rasputin15"},/area/shuttle/drop2/sulaco)
"cX" = (/turf/closed/shuttle/dropship2/transparent{icon_state = "96"},/area/shuttle/drop2/sulaco)
"dk" = (/turf/closed/shuttle/dropship2{icon_state = "75"},/area/shuttle/drop2/sulaco)
"dt" = (/turf/closed/shuttle/dropship2{icon_state = "19"},/area/shuttle/drop2/sulaco)
"dU" = (/obj/structure/shuttle/part/dropship2/transparent/upper_left_wing,/turf/template_noop,/area/shuttle/drop2/sulaco)
"dZ" = (/obj/structure/shuttle/part/dropship2/transparent/engine_left_exhaust,/turf/template_noop,/area/shuttle/drop2/sulaco)
"eM" = (/obj/structure/shuttle/part/dropship2/transparent/nose_top_right,/turf/template_noop,/area/shuttle/drop2/sulaco)
"eV" = (/turf/closed/shuttle/dropship2{icon_state = "50"},/area/shuttle/drop2/sulaco)
"fi" = (/turf/closed/shuttle/dropship2{icon_state = "69"},/area/shuttle/drop2/sulaco)
"fj" = (/turf/closed/shuttle/dropship2{icon_state = "72"},/area/shuttle/drop2/sulaco)
"fL" = (/obj/structure/platform{dir = 4},/turf/open/shuttle/dropship{icon_state = "rasputin15"},/area/shuttle/drop2/sulaco)
"gJ" = (/obj/structure/bed/chair/vehicle{pixel_x = -8},/obj/structure/bed/chair/vehicle{pixel_x = 8},/obj/item/device/radio/intercom/normandy{pixel_y = 24},/turf/open/shuttle/dropship{icon_state = "rasputin15"},/area/shuttle/drop2/sulaco)
"gT" = (/obj/structure/machinery/cm_vending/sorted/cargo_guns/squad_prep{req_access = null; req_one_access = null},/turf/open/shuttle/dropship{icon_state = "rasputin15"},/area/shuttle/drop2/sulaco)
"gV" = (/turf/closed/shuttle/dropship2{icon_state = "82"},/area/shuttle/drop2/sulaco)
"hc" = (/obj/structure/shuttle/part/dropship2/transparent/nose_top_left,/turf/template_noop,/area/shuttle/drop2/sulaco)
"hx" = (/turf/closed/shuttle/dropship2{icon_state = "94"},/area/shuttle/drop2/sulaco)
"hG" = (/obj/structure/machinery/door/airlock/hatch/cockpit/two,/obj/structure/blocker/forcefield/multitile_vehicles,/turf/open/shuttle/dropship{icon_state = "rasputin15"},/area/shuttle/drop2/sulaco)
"hH" = (/turf/closed/shuttle/dropship2{icon_state = "51"},/area/shuttle/drop2/sulaco)
"hS" = (/obj/effect/attach_point/fuel/dropship2,/turf/closed/shuttle/dropship2/transparent{icon_state = "28"},/area/shuttle/drop2/sulaco)
"ic" = (/obj/effect/decal/warning_stripes{icon_state = "SE-out"; pixel_x = 1},/turf/open/shuttle/dropship{icon_state = "rasputin15"},/area/shuttle/drop2/sulaco)
"it" = (/obj/effect/attach_point/electronics/dropship2{dir = 1},/obj/structure/shuttle/part/dropship2/transparent/inner_left_weapons,/turf/template_noop,/area/shuttle/drop2/sulaco)
"iz" = (/turf/open/shuttle/dropship{icon_state = "floor8"},/area/shuttle/drop2/sulaco)
"iL" = (/obj/structure/blocker/forcefield/multitile_vehicles,/turf/open/shuttle/dropship{icon_state = "rasputin15"},/area/shuttle/drop2/sulaco)
"jM" = (/obj/effect/decal/warning_stripes{icon_state = "E"; pixel_x = 1},/obj/structure/blocker/forcefield/multitile_vehicles,/turf/open/shuttle/dropship{icon_state = "rasputin15"},/area/shuttle/drop2/sulaco)
"jP" = (/obj/structure/shuttle/part/dropship2/transparent/engine_left_cap,/turf/template_noop,/area/shuttle/drop2/sulaco)
"kp" = (/turf/closed/shuttle/dropship2/transparent{icon_state = "27"},/area/shuttle/drop2/sulaco)
"ky" = (/obj/item/device/radio/intercom/normandy{pixel_y = 24},/turf/open/shuttle/dropship{icon_state = "rasputin15"},/area/shuttle/drop2/sulaco)
"kC" = (/turf/closed/shuttle/dropship2{icon_state = "24"},/area/shuttle/drop2/sulaco)
"lN" = (/turf/closed/shuttle/dropship2/transparent{icon_state = "39"},/area/shuttle/drop2/sulaco)
"mA" = (/obj/effect/attach_point/weapon/dropship2/right_wing,/obj/structure/shuttle/part/dropship2/transparent/lower_right_wing,/turf/template_noop,/area/shuttle/drop2/sulaco)
"mL" = (/obj/structure/platform{dir = 8},/turf/open/shuttle/dropship{icon_state = "rasputin15"},/area/shuttle/drop2/sulaco)
"ok" = (/obj/structure/shuttle/part/dropship2/transparent/middle_right_wing,/turf/template_noop,/area/shuttle/drop2/sulaco)
"ot" = (/obj/structure/platform{dir = 4},/obj/structure/machinery/camera/autoname/almayer/dropship_two{dir = 8; pixel_x = 16},/turf/open/shuttle/dropship{icon_state = "rasputin15"},/area/shuttle/drop2/sulaco)
"oF" = (/turf/closed/shuttle/dropship2{icon_state = "83"},/area/shuttle/drop2/sulaco)
"oJ" = (/obj/structure/shuttle/part/dropship2/transparent/nose_center,/turf/template_noop,/area/shuttle/drop2/sulaco)
"pO" = (/obj/structure/blocker/forcefield/multitile_vehicles,/turf/open/shuttle/dropship{icon_state = "rasputin4"},/area/shuttle/drop2/sulaco)
"qh" = (/obj/effect/decal/warning_stripes{icon_state = "W"},/turf/open/shuttle/dropship{icon_state = "rasputin15"},/area/shuttle/drop2/sulaco)
"qT" = (/turf/open/shuttle/dropship{icon_state = "rasputin3"},/area/shuttle/drop2/sulaco)
"rh" = (/turf/open/shuttle/dropship{icon_state = "rasputin7"},/area/shuttle/drop2/sulaco)
"tr" = (/obj/structure/shuttle/part/dropship2/lower_left_wall,/turf/open/space/basic,/area/shuttle/drop2/sulaco)
"tX" = (/obj/structure/shuttle/part/dropship2/right_outer_wing_connector,/turf/open/space/basic,/area/shuttle/drop2/sulaco)
"uj" = (/obj/structure/platform{dir = 8},/obj/structure/stairs,/turf/open/shuttle/dropship{icon_state = "rasputin15"},/area/shuttle/drop2/sulaco)
"uu" = (/obj/structure/closet/fireaxecabinet{pixel_y = -10},/turf/closed/shuttle/dropship2{icon_state = "76"},/area/shuttle/drop2/sulaco)
"vh" = (/turf/closed/shuttle/dropship2/transparent{icon_state = "86"},/area/shuttle/drop2/sulaco)
"vB" = (/obj/structure/shuttle/part/dropship2/left_outer_wing_connector,/turf/open/space/basic,/area/shuttle/drop2/sulaco)
"vV" = (/obj/structure/platform{dir = 1; layer = 2.8},/obj/effect/decal/warning_stripes{icon_state = "E"; pixel_x = 1},/turf/open/shuttle/dropship{icon_state = "rasputin3"},/area/shuttle/drop2/sulaco)
"vX" = (/obj/structure/platform{dir = 1; layer = 2.8},/turf/open/shuttle/dropship{icon_state = "rasputin15"},/area/shuttle/drop2/sulaco)
"wa" = (/turf/closed/shuttle/dropship2{icon_state = "37"},/area/shuttle/drop2/sulaco)
"wk" = (/turf/closed/shuttle/dropship2/transparent{icon_state = "89"},/area/shuttle/drop2/sulaco)
"ww" = (/obj/structure/blocker/forcefield/multitile_vehicles,/turf/open/shuttle/dropship{icon_state = "rasputin8"},/area/shuttle/drop2/sulaco)
"wS" = (/obj/effect/attach_point/weapon/dropship2/left_wing,/obj/structure/shuttle/part/dropship2/transparent/lower_left_wing,/turf/template_noop,/area/shuttle/drop2/sulaco)
"wZ" = (/turf/closed/shuttle/dropship2/transparent{icon_state = "34"},/area/shuttle/drop2/sulaco)
"xf" = (/obj/effect/attach_point/weapon/dropship2/right_fore,/obj/structure/shuttle/part/dropship2/transparent/outer_right_weapons,/turf/template_noop,/area/shuttle/drop2/sulaco)
"xp" = (/turf/template_noop,/area/template_noop)
"xX" = (/obj/structure/shuttle/part/dropship2/transparent/upper_right_wing,/turf/template_noop,/area/shuttle/drop2/sulaco)
"yc" = (/obj/effect/attach_point/fuel/dropship2{pixel_x = -32},/turf/closed/shuttle/dropship2/transparent{icon_state = "33"},/area/shuttle/drop2/sulaco)
"ye" = (/obj/structure/shuttle/part/dropship2/transparent/right_inner_bottom_wing,/turf/template_noop,/area/shuttle/drop2/sulaco)
"ym" = (/turf/closed/shuttle/dropship2/transparent{icon_state = "35"},/area/shuttle/drop2/sulaco)
"AZ" = (/obj/item/device/radio/intercom/normandy{layer = 3.5; pixel_x = 10},/turf/closed/shuttle/dropship2{icon_state = "54"},/area/shuttle/drop2/sulaco)
"Bx" = (/obj/structure/shuttle/part/dropship2/transparent/right_outer_bottom_wing,/turf/template_noop,/area/shuttle/drop2/sulaco)
"CD" = (/turf/closed/shuttle/dropship2{icon_state = "92"},/area/shuttle/drop2/sulaco)
"CU" = (/obj/structure/machinery/door/airlock/multi_tile/almayer/dropshiprear/ds2{id = "aft_door"},/obj/effect/decal/warning_stripes{icon_state = "E"; pixel_x = 1},/turf/open/shuttle/dropship{icon_state = "rasputin15"},/area/shuttle/drop2/sulaco)
"Eo" = (/obj/structure/platform{dir = 4},/obj/structure/stairs,/turf/open/shuttle/dropship{icon_state = "rasputin15"},/area/shuttle/drop2/sulaco)
"Ez" = (/turf/closed/shuttle/dropship2{icon_state = "67"},/area/shuttle/drop2/sulaco)
"EL" = (/obj/structure/platform{dir = 8},/obj/structure/platform,/turf/open/shuttle/dropship{icon_state = "rasputin15"},/area/shuttle/drop2/sulaco)
"ER" = (/obj/structure/bed/chair/office/dark{dir = 8; layer = 3.25},/obj/structure/machinery/computer/overwatch/almayer{dir = 8; pixel_x = -17; pixel_y = 20},/obj/structure/machinery/computer/groundside_operations{dir = 4; pixel_x = -17; pixel_y = 6},/obj/structure/machinery/computer/overwatch/almayer{dir = 8; pixel_x = -17; pixel_y = -10},/obj/structure/platform/ship{dir = 4},/turf/open/shuttle/dropship{icon_state = "rasputin15"},/area/shuttle/drop2/sulaco)
"FF" = (/obj/structure/shuttle/part/dropship2/transparent/middle_left_wing,/turf/template_noop,/area/shuttle/drop2/sulaco)
"FW" = (/turf/closed/shuttle/dropship2{icon_state = "42"},/area/shuttle/drop2/sulaco)
"Gg" = (/obj/item/device/radio/intercom/normandy{layer = 3.5; pixel_x = 21; pixel_y = 43},/turf/open/shuttle/dropship{icon_state = "rasputin15"},/area/shuttle/drop2/sulaco)
"Gl" = (/obj/structure/blocker/forcefield/multitile_vehicles,/turf/open/shuttle/dropship{icon_state = "rasputin5"},/area/shuttle/drop2/sulaco)
"Gs" = (/obj/structure/machinery/cm_vending/sorted/cargo_guns/squad{req_access = null; req_one_access = null},/turf/open/shuttle/dropship{icon_state = "rasputin15"},/area/shuttle/drop2/sulaco)
"Gu" = (/obj/structure/bed/chair/vehicle{pixel_x = -8},/obj/structure/bed/chair/vehicle{pixel_x = 8},/turf/open/shuttle/dropship{icon_state = "rasputin15"},/area/shuttle/drop2/sulaco)
"Gz" = (/turf/closed/shuttle/dropship2/transparent{icon_state = "22"},/area/shuttle/drop2/sulaco)
"HP" = (/obj/structure/shuttle/part/dropship2/transparent/engine_right_cap,/turf/template_noop,/area/shuttle/drop2/sulaco)
"IK" = (/turf/closed/shuttle/dropship2{icon_state = "77"},/area/shuttle/drop2/sulaco)
"IN" = (/obj/effect/decal/warning_stripes{icon_state = "S"},/turf/open/shuttle/dropship{icon_state = "rasputin15"},/area/shuttle/drop2/sulaco)
"IS" = (/obj/structure/shuttle/part/dropship2/transparent/left_outer_inner_wing,/turf/template_noop,/area/shuttle/drop2/sulaco)
"Jp" = (/obj/effect/attach_point/crew_weapon/dropship2,/obj/effect/decal/warning_stripes,/turf/open/shuttle/dropship{icon_state = "rasputin15"},/area/shuttle/drop2/sulaco)
"Jw" = (/obj/structure/shuttle/part/dropship2/nose_front_right,/turf/template_noop,/area/shuttle/drop2/sulaco)
"JC" = (/obj/effect/attach_point/electronics/dropship2{dir = 1},/obj/structure/shuttle/part/dropship2/transparent/inner_right_weapons,/turf/template_noop,/area/shuttle/drop2/sulaco)
"JM" = (/turf/closed/shuttle/dropship2/transparent{icon_state = "97"},/area/shuttle/drop2/sulaco)
"JO" = (/obj/structure/machinery/cm_vending/sorted/medical/wall_med/vehicle{pixel_x = 5; pixel_y = -6},/turf/closed/shuttle/dropship2/transparent{icon_state = "80"},/area/shuttle/drop2/sulaco)
"JV" = (/obj/effect/decal/warning_stripes{icon_state = "E"; pixel_x = 1},/turf/open/shuttle/dropship{icon_state = "rasputin15"},/area/shuttle/drop2/sulaco)
"KY" = (/obj/structure/shuttle/part/dropship2/nose_front_left,/turf/template_noop,/area/shuttle/drop2/sulaco)
"Mx" = (/obj/structure/platform{dir = 4},/obj/structure/platform,/turf/open/shuttle/dropship{icon_state = "rasputin15"},/area/shuttle/drop2/sulaco)
"MH" = (/obj/structure/extinguisher_cabinet/alt{pixel_x = -14; pixel_y = -9},/turf/closed/shuttle/dropship2{icon_state = "81"},/area/shuttle/drop2/sulaco)
"MJ" = (/turf/open/shuttle/dropship{icon_state = "rasputin15"},/area/shuttle/drop2/sulaco)
"NZ" = (/obj/structure/machinery/door_control{id = "dropship_normandy"; name = "Dropship Lockdown"; normaldoorcontrol = 3; pixel_y = -19; req_one_access_txt = "3;22"; throw_range = 15},/turf/closed/shuttle/dropship2/transparent{icon_state = "78"},/area/shuttle/drop2/sulaco)
"Os" = (/obj/structure/shuttle/part/dropship2/transparent/left_outer_bottom_wing,/turf/template_noop,/area/shuttle/drop2/sulaco)
"OC" = (/obj/effect/attach_point/weapon/dropship2/left_fore,/obj/structure/shuttle/part/dropship2/transparent/outer_left_weapons,/turf/template_noop,/area/shuttle/drop2/sulaco)
"OU" = (/turf/closed/shuttle/dropship2/transparent{icon_state = "38"},/area/shuttle/drop2/sulaco)
"Pg" = (/turf/closed/shuttle/dropship2{icon_state = "64"},/area/shuttle/drop2/sulaco)
"PT" = (/obj/structure/bed/chair/dropship/pilot{dir = 1},/obj/structure/machinery/camera/autoname/almayer/dropship_two{pixel_x = 8; pixel_y = -16},/turf/open/shuttle/dropship{icon_state = "rasputin15"},/area/shuttle/drop2/sulaco)
"Qe" = (/obj/structure/shuttle/part/dropship2/left_inner_wing_connector,/turf/open/space/basic,/area/shuttle/drop2/sulaco)
"Qf" = (/obj/structure/blocker/invisible_wall,/obj/structure/machinery/computer/cameras/dropship/two,/turf/open/shuttle/dropship{icon_state = "rasputin15"},/area/shuttle/drop2/sulaco)
"Qt" = (/obj/structure/bed/chair/dropship/pilot{dir = 1},/turf/open/shuttle/dropship{icon_state = "rasputin15"},/area/shuttle/drop2/sulaco)
"QF" = (/obj/structure/shuttle/part/dropship2/transparent/engine_right_exhaust,/turf/template_noop,/area/shuttle/drop2/sulaco)
"QU" = (/obj/item/device/radio/intercom/normandy{layer = 3.5; pixel_x = -10},/turf/closed/shuttle/dropship2{icon_state = "52"},/area/shuttle/drop2/sulaco)
"QV" = (/obj/structure/bed/chair/vehicle{dir = 1; pixel_x = 8},/obj/structure/bed/chair/vehicle{dir = 1; pixel_x = -8},/turf/open/shuttle/dropship{icon_state = "rasputin15"},/area/shuttle/drop2/sulaco)
"Ra" = (/obj/structure/platform{dir = 1; layer = 2.8},/obj/effect/decal/warning_stripes{icon_state = "W"},/turf/open/shuttle/dropship{icon_state = "rasputin3"},/area/shuttle/drop2/sulaco)
"Sh" = (/obj/structure/machinery/computer/dropship_weapons/dropship2,/obj/structure/transmitter/rotary{name = "Normandy Telephone"; phone_category = "Dropship"; phone_id = "Normandy"; pixel_x = 11; pixel_y = 16},/obj/structure/blocker/invisible_wall,/turf/open/shuttle/dropship{icon_state = "rasputin15"},/area/shuttle/drop2/sulaco)
"SO" = (/turf/closed/shuttle/dropship2/transparent{icon_state = "26"},/area/shuttle/drop2/sulaco)
"Ta" = (/obj/structure/machinery/door/airlock/dropship_hatch/two{id = "port_door"},/obj/structure/stairs{dir = 8; icon_state = "ramptop"},/obj/structure/blocker/forcefield/multitile_vehicles,/turf/open/shuttle/dropship{icon_state = "rasputin15"},/area/shuttle/drop2/sulaco)
"Te" = (/turf/closed/shuttle/dropship2{icon_state = "30"},/area/shuttle/drop2/sulaco)
"TO" = (/obj/structure/shuttle/part/dropship2/right_inner_wing_connector,/turf/open/space/basic,/area/shuttle/drop2/sulaco)
"TY" = (/obj/structure/blocker/invisible_wall,/obj/structure/machinery/computer/shuttle/dropship/flight,/turf/open/shuttle/dropship{icon_state = "rasputin15"},/area/shuttle/drop2/sulaco)
"Uf" = (/obj/structure/shuttle/part/dropship2/bottom_right_wall,/turf/template_noop,/area/shuttle/drop2/sulaco)
"Uk" = (/turf/closed/shuttle/dropship2{icon_state = "10"},/area/shuttle/drop2/sulaco)
"Ut" = (/obj/structure/stairs,/obj/structure/platform/ship{dir = 4},/turf/open/shuttle/dropship{icon_state = "rasputin15"},/area/shuttle/drop2/sulaco)
"UV" = (/turf/closed/shuttle/dropship2{icon_state = "18"},/area/shuttle/drop2/sulaco)
"UX" = (/turf/closed/shuttle/dropship2{icon_state = "14"},/area/shuttle/drop2/sulaco)
"Vf" = (/turf/closed/shuttle/dropship2{icon_state = "36"},/area/shuttle/drop2/sulaco)
"Vm" = (/obj/structure/bed/chair/vehicle{dir = 1; pixel_x = 8},/obj/structure/bed/chair/vehicle{dir = 1; pixel_x = -8},/obj/structure/machinery/camera/autoname/almayer/dropship_two{dir = 4; pixel_x = -16},/turf/open/shuttle/dropship{icon_state = "rasputin15"},/area/shuttle/drop2/sulaco)
"Vn" = (/turf/closed/shuttle/dropship2/transparent{icon_state = "32"},/area/shuttle/drop2/sulaco)
"VK" = (/obj/structure/shuttle/part/dropship2/bottom_left_wall,/turf/template_noop,/area/shuttle/drop2/sulaco)
"Xm" = (/turf/open/shuttle/dropship{icon_state = "rasputin6"},/area/shuttle/drop2/sulaco)
"XD" = (/turf/closed/shuttle/dropship2{icon_state = "73"},/area/shuttle/drop2/sulaco)
"XN" = (/obj/effect/decal/warning_stripes{icon_state = "E"; pixel_x = 1},/turf/open/shuttle/dropship{icon_state = "rasputin3"},/area/shuttle/drop2/sulaco)
"XY" = (/turf/closed/shuttle/dropship2{icon_state = "62"},/area/shuttle/drop2/sulaco)
"Yr" = (/turf/closed/shuttle/dropship2/transparent{icon_state = "98"},/area/shuttle/drop2/sulaco)
"YD" = (/turf/closed/shuttle/dropship2{icon_state = "43"},/area/shuttle/drop2/sulaco)
"YS" = (/turf/closed/shuttle/dropship2/transparent{icon_state = "29"},/area/shuttle/drop2/sulaco)
"Zj" = (/turf/closed/shuttle/dropship2{icon_state = "25"},/area/shuttle/drop2/sulaco)

(1,1,1) = {"
xpxpxphcoJoJoJeMxpxpxp
xpxpxpKYcXJMYrJwxpxpxp
xpxpxpCDQfTYShhxxpxpxp
xpOCitvhPTGgQtwkJCxfxp
xpdkuuIKNZhGJOMHgVoFxp
dUfjGugJXmizrhgJGuXDxX
FFEzVmQVqTJpqTQVQVfiok
wSXYGuGuqTMJqTGuGuPgmA
xpTaMJMJqTJpqTMJMJcMxp
xpTaMJMJqTMJqTicINcMxp
xpQUUtMJqTbFqTJVGsAZxp
xpeVERiLpOGlwwjMgThHxp
xptrUkujvVvXRaEoUXatxp
jPHPFWmLXNkycFfLYDjPHP
wZymVfmLXNMJcFfLwaOUlN
hSYSTemLXNMJcFotbVVnyc
GzbkkCmLXNMJcFfLZjSOkp
dZQFUVELXNMJcFMxdtdZQF
xpxpVKUkCUMJqhUXUfxpxp
xpxpxpQexpxpxpTOxpxpxp
xpOsISvBxpxpxptXyeBxxp
"}
