"at" = (/obj/structure/shuttle/part/dropship1/lower_right_wall,/turf/open/space/basic,/area/space)
"bk" = (/turf/closed/shuttle/dropship1/transparent{icon_state = "23"},/area/space)
"bF" = (/obj/effect/decal/warning_stripes,/obj/docking_port/mobile/marine_dropship/attu,/obj/effect/attach_point/crew_weapon/attu,/turf/open/shuttle/dropship{icon_state = "rasputin15"},/area/space)
"bV" = (/turf/closed/shuttle/dropship1{icon_state = "31"},/area/space)
"cF" = (/obj/effect/decal/warning_stripes{icon_state = "W"},/turf/open/shuttle/dropship{icon_state = "rasputin3"},/area/space)
"cM" = (/obj/structure/machinery/door/airlock/dropship_hatch{dir = 8; id = "starboard_door"},/obj/structure/stairs{dir = 4},/obj/structure/blocker/forcefield/multitile_vehicles,/turf/open/shuttle/dropship{icon_state = "rasputin15"},/area/space)
"cX" = (/turf/closed/shuttle/dropship1/transparent{icon_state = "96"},/area/space)
"dk" = (/turf/closed/shuttle/dropship1{icon_state = "75"},/area/space)
"dU" = (/obj/structure/shuttle/part/dropship1/transparent/upper_left_wing,/turf/template_noop,/area/space)
"dZ" = (/obj/structure/shuttle/part/dropship1/transparent/engine_left_exhaust,/turf/open/space/basic,/area/space)
"eM" = (/obj/structure/shuttle/part/dropship1/transparent/nose_top_right,/turf/template_noop,/area/space)
"eV" = (/turf/closed/shuttle/dropship1{icon_state = "50"},/area/space)
"fi" = (/turf/closed/shuttle/dropship1{icon_state = "69"},/area/space)
"fj" = (/turf/closed/shuttle/dropship1{icon_state = "72"},/area/space)
"fL" = (/obj/structure/platform{dir = 4},/turf/open/shuttle/dropship{icon_state = "rasputin15"},/area/space)
"gJ" = (/obj/structure/bed/chair/vehicle{pixel_x = -8},/obj/structure/bed/chair/vehicle{pixel_x = 8},/obj/item/device/radio/intercom/alamo{pixel_y = 24},/turf/open/shuttle/dropship{icon_state = "rasputin15"},/area/space)
"gT" = (/obj/structure/machinery/cm_vending/sorted/cargo_guns/squad_prep{req_access = null; req_one_access = null},/turf/open/shuttle/dropship{icon_state = "rasputin15"},/area/space)
"gV" = (/turf/closed/shuttle/dropship1{icon_state = "76"},/area/space)
"hc" = (/obj/structure/shuttle/part/dropship1/transparent/nose_top_left,/turf/template_noop,/area/space)
"hx" = (/turf/closed/shuttle/dropship1{icon_state = "94"},/area/space)
"hG" = (/obj/structure/machinery/door/airlock/hatch/cockpit,/obj/structure/blocker/forcefield/multitile_vehicles,/turf/open/shuttle/dropship{icon_state = "rasputin15"},/area/space)
"hH" = (/turf/closed/shuttle/dropship1{icon_state = "51"},/area/space)
"hS" = (/obj/effect/attach_point/fuel/dropship1,/turf/closed/shuttle/dropship1/transparent{icon_state = "28"},/area/space)
"ic" = (/obj/effect/decal/warning_stripes{icon_state = "SE-out"; pixel_x = 1},/turf/open/shuttle/dropship{icon_state = "rasputin15"},/area/space)
"it" = (/obj/effect/attach_point/electronics/dropship1{dir = 1},/obj/structure/shuttle/part/dropship1/transparent/inner_left_weapons,/turf/template_noop,/area/space)
"iu" = (/obj/structure/machinery/camera/autoname/almayer/dropship_one{dir = 4; pixel_x = -16},/obj/structure/platform{dir = 8},/turf/open/shuttle/dropship{icon_state = "rasputin15"},/area/space)
"iz" = (/turf/open/shuttle/dropship{icon_state = "floor8"},/area/space)
"iL" = (/obj/structure/blocker/forcefield/multitile_vehicles,/turf/open/shuttle/dropship{icon_state = "rasputin15"},/area/space)
"jM" = (/obj/effect/decal/warning_stripes{icon_state = "E"; pixel_x = 1},/obj/structure/blocker/forcefield/multitile_vehicles,/turf/open/shuttle/dropship{icon_state = "rasputin15"},/area/space)
"jP" = (/obj/structure/shuttle/part/dropship1/transparent/engine_left_cap,/turf/template_noop,/area/space)
"kp" = (/turf/closed/shuttle/dropship1/transparent{icon_state = "27"},/area/space)
"ky" = (/obj/item/device/radio/intercom/alamo{pixel_y = 24},/turf/open/shuttle/dropship{icon_state = "rasputin15"},/area/space)
"kC" = (/turf/closed/shuttle/dropship1{icon_state = "24"},/area/space)
"lN" = (/turf/closed/shuttle/dropship1/transparent{icon_state = "39"},/area/space)
"mA" = (/obj/effect/attach_point/weapon/dropship1/right_wing,/obj/structure/shuttle/part/dropship1/transparent/lower_right_wing,/turf/template_noop,/area/space)
"mL" = (/obj/structure/platform{dir = 8},/turf/open/shuttle/dropship{icon_state = "rasputin15"},/area/space)
"ok" = (/obj/structure/shuttle/part/dropship1/transparent/middle_right_wing,/turf/template_noop,/area/space)
"oF" = (/turf/closed/shuttle/dropship1{icon_state = "83"},/area/space)
"oJ" = (/obj/structure/shuttle/part/dropship1/transparent/nose_center,/turf/template_noop,/area/space)
"pO" = (/obj/structure/blocker/forcefield/multitile_vehicles,/turf/open/shuttle/dropship{icon_state = "rasputin4"},/area/space)
"qh" = (/obj/effect/decal/warning_stripes{icon_state = "W"},/turf/open/shuttle/dropship{icon_state = "rasputin15"},/area/space)
"qT" = (/turf/open/shuttle/dropship{icon_state = "rasputin3"},/area/space)
"rh" = (/turf/open/shuttle/dropship{icon_state = "rasputin7"},/area/space)
"tr" = (/obj/structure/shuttle/part/dropship1/lower_left_wall,/turf/open/space/basic,/area/space)
"tX" = (/obj/structure/shuttle/part/dropship1/right_outer_wing_connector,/turf/open/space/basic,/area/space)
"uj" = (/obj/structure/platform{dir = 8},/obj/structure/stairs,/turf/open/shuttle/dropship{icon_state = "rasputin15"},/area/space)
"uu" = (/obj/structure/closet/fireaxecabinet{pixel_y = -10},/turf/closed/shuttle/dropship1{icon_state = "76"},/area/space)
"vh" = (/turf/closed/shuttle/dropship1/transparent{icon_state = "86"},/area/space)
"vB" = (/obj/structure/shuttle/part/dropship1/left_outer_wing_connector,/turf/open/space/basic,/area/space)
"vV" = (/obj/structure/platform{dir = 1; layer = 2.8},/obj/effect/decal/warning_stripes{icon_state = "E"; pixel_x = 1},/turf/open/shuttle/dropship{icon_state = "rasputin3"},/area/space)
"vX" = (/obj/structure/platform{dir = 1; layer = 2.8},/turf/open/shuttle/dropship{icon_state = "rasputin15"},/area/space)
"wk" = (/turf/closed/shuttle/dropship1/transparent{icon_state = "89"},/area/space)
"ww" = (/obj/structure/blocker/forcefield/multitile_vehicles,/turf/open/shuttle/dropship{icon_state = "rasputin8"},/area/space)
"wS" = (/obj/effect/attach_point/weapon/dropship1/left_wing,/obj/structure/shuttle/part/dropship1/transparent/lower_left_wing,/turf/template_noop,/area/space)
"wZ" = (/turf/closed/shuttle/dropship1/transparent{icon_state = "34"},/area/space)
"xf" = (/obj/structure/shuttle/part/dropship1/transparent/outer_right_weapons,/turf/template_noop,/area/space)
"xp" = (/turf/template_noop,/area/space)
"xX" = (/obj/structure/shuttle/part/dropship1/transparent/upper_right_wing,/turf/template_noop,/area/space)
"yc" = (/obj/effect/attach_point/fuel/dropship1{pixel_x = -32},/turf/closed/shuttle/dropship1/transparent{icon_state = "33"},/area/space)
"ye" = (/obj/structure/shuttle/part/dropship1/transparent/right_inner_bottom_wing,/turf/template_noop,/area/space)
"ym" = (/turf/closed/shuttle/dropship1/transparent{icon_state = "35"},/area/space)
"AZ" = (/obj/item/device/radio/intercom/alamo{pixel_x = 10},/turf/closed/shuttle/dropship1{icon_state = "54"},/area/space)
"Bx" = (/obj/structure/shuttle/part/dropship1/transparent/right_outer_bottom_wing,/turf/template_noop,/area/space)
"CD" = (/turf/closed/shuttle/dropship1{icon_state = "92"},/area/space)
"CU" = (/obj/structure/machinery/door/airlock/multi_tile/almayer/dropshiprear/ds1{id = "aft_door"},/obj/effect/decal/warning_stripes{icon_state = "E"; pixel_x = 1},/turf/open/shuttle/dropship{icon_state = "rasputin15"},/area/space)
"Eo" = (/obj/structure/platform{dir = 4},/obj/structure/stairs,/turf/open/shuttle/dropship{icon_state = "rasputin15"},/area/space)
"Ez" = (/turf/closed/shuttle/dropship1{icon_state = "67"},/area/space)
"EL" = (/obj/structure/platform{dir = 8},/obj/structure/platform,/turf/open/shuttle/dropship{icon_state = "rasputin15"},/area/space)
"ER" = (/obj/structure/bed/chair/office/dark{dir = 8; layer = 3.25},/obj/structure/machinery/computer/overwatch/almayer{dir = 8; pixel_x = -17; pixel_y = 20},/obj/structure/machinery/computer/groundside_operations{dir = 4; pixel_x = -17; pixel_y = 6},/obj/structure/machinery/computer/overwatch/almayer{dir = 8; pixel_x = -17; pixel_y = -10},/obj/structure/platform/ship{dir = 4},/turf/open/shuttle/dropship{icon_state = "rasputin15"},/area/space)
"FF" = (/obj/structure/shuttle/part/dropship1/transparent/middle_left_wing,/turf/template_noop,/area/space)
"FW" = (/turf/closed/shuttle/dropship1{icon_state = "42"},/area/space)
"Gg" = (/obj/item/device/radio/intercom/alamo{layer = 3.5; pixel_x = 21; pixel_y = 43},/turf/open/shuttle/dropship{icon_state = "rasputin15"},/area/space)
"Gl" = (/obj/structure/blocker/forcefield/multitile_vehicles,/turf/open/shuttle/dropship{icon_state = "rasputin5"},/area/space)
"Gs" = (/obj/structure/machinery/cm_vending/sorted/cargo_guns/squad{req_access = null; req_one_access = null},/turf/open/shuttle/dropship{icon_state = "rasputin15"},/area/space)
"Gu" = (/obj/structure/bed/chair/vehicle{pixel_x = -8},/obj/structure/bed/chair/vehicle{pixel_x = 8},/turf/open/shuttle/dropship{icon_state = "rasputin15"},/area/space)
"Gz" = (/turf/closed/shuttle/dropship1/transparent{icon_state = "22"},/area/space)
"HP" = (/obj/structure/shuttle/part/dropship1/transparent/engine_right_cap,/turf/template_noop,/area/space)
"IK" = (/turf/closed/shuttle/dropship1{icon_state = "81"},/area/space)
"IN" = (/obj/effect/decal/warning_stripes{icon_state = "S"},/turf/open/shuttle/dropship{icon_state = "rasputin15"},/area/space)
"IS" = (/obj/structure/shuttle/part/dropship1/transparent/left_outer_bottom_wing,/turf/template_noop,/area/space)
"Jp" = (/obj/effect/decal/warning_stripes,/obj/effect/attach_point/crew_weapon/attu,/turf/open/shuttle/dropship{icon_state = "rasputin15"},/area/space)
"Jw" = (/obj/structure/shuttle/part/dropship1/nose_front_right,/turf/template_noop,/area/space)
"JC" = (/obj/effect/attach_point/electronics/dropship1{dir = 1},/obj/structure/shuttle/part/dropship1/transparent/inner_right_weapons,/turf/template_noop,/area/space)
"JM" = (/turf/closed/shuttle/dropship1/transparent{icon_state = "97"},/area/space)
"JO" = (/obj/structure/machinery/cm_vending/sorted/medical/wall_med/vehicle{pixel_x = 5; pixel_y = -6},/turf/closed/shuttle/dropship1/transparent{icon_state = "80"},/area/space)
"JV" = (/obj/effect/decal/warning_stripes{icon_state = "E"; pixel_x = 1},/turf/open/shuttle/dropship{icon_state = "rasputin15"},/area/space)
"KY" = (/obj/structure/shuttle/part/dropship1/nose_front_left,/turf/template_noop,/area/space)
"Mx" = (/obj/structure/platform{dir = 4},/obj/structure/platform,/turf/open/shuttle/dropship{icon_state = "rasputin15"},/area/space)
"MH" = (/obj/structure/extinguisher_cabinet/alt{pixel_x = -14; pixel_y = -9},/turf/closed/shuttle/dropship1{icon_state = "77"},/area/space)
"MJ" = (/turf/open/shuttle/dropship{icon_state = "rasputin15"},/area/space)
"NZ" = (/obj/structure/machinery/door_control{id = "dropship_alamo"; name = "Dropship Lockdown"; normaldoorcontrol = 3; pixel_y = -19; req_one_access_txt = "3;22"; throw_range = 15},/turf/closed/shuttle/dropship1/transparent{icon_state = "78"},/area/space)
"Os" = (/obj/structure/shuttle/part/dropship1/transparent/left_inner_bottom_wing,/turf/template_noop,/area/space)
"OC" = (/obj/effect/attach_point/weapon/dropship1/left_fore,/obj/structure/shuttle/part/dropship1/transparent/outer_left_weapons,/turf/template_noop,/area/space)
"OU" = (/turf/closed/shuttle/dropship1/transparent{icon_state = "38"},/area/space)
"Pg" = (/turf/closed/shuttle/dropship1{icon_state = "64"},/area/space)
"PT" = (/obj/structure/bed/chair/dropship/pilot{dir = 1},/turf/open/shuttle/dropship{icon_state = "rasputin15"},/area/space)
"Qe" = (/obj/structure/shuttle/part/dropship1/left_inner_wing_connector,/turf/open/space/basic,/area/space)
"Qf" = (/obj/structure/prop/ice_colony/hula_girl{pixel_x = -10; pixel_y = 16},/obj/structure/blocker/invisible_wall,/obj/structure/machinery/computer/cameras/dropship/one,/turf/open/shuttle/dropship{icon_state = "rasputin15"},/area/space)
"Qt" = (/obj/structure/bed/chair/dropship/pilot{dir = 1},/obj/structure/machinery/camera/autoname/almayer/dropship_one{pixel_x = -6; pixel_y = -16},/turf/open/shuttle/dropship{icon_state = "rasputin15"},/area/space)
"QF" = (/obj/structure/shuttle/part/dropship1/transparent/engine_right_exhaust,/turf/open/space/basic,/area/space)
"QU" = (/obj/item/device/radio/intercom/alamo{pixel_x = -10},/turf/closed/shuttle/dropship1{icon_state = "52"},/area/space)
"QV" = (/obj/structure/machinery/camera/autoname/almayer/dropship_one{dir = 8; pixel_x = 16},/obj/structure/bed/chair/vehicle{dir = 1; pixel_x = 8},/obj/structure/bed/chair/vehicle{dir = 1; pixel_x = -8},/turf/open/shuttle/dropship{icon_state = "rasputin15"},/area/space)
"Ra" = (/obj/structure/platform{dir = 1; layer = 2.8},/obj/effect/decal/warning_stripes{icon_state = "W"},/turf/open/shuttle/dropship{icon_state = "rasputin3"},/area/space)
"Sh" = (/obj/structure/machinery/computer/dropship_weapons/dropship1,/obj/structure/transmitter/rotary{name = "Alamo Telephone"; phone_category = "Dropship"; phone_id = "Alamo"; pixel_x = 11; pixel_y = 16},/obj/structure/blocker/invisible_wall,/turf/open/shuttle/dropship{icon_state = "rasputin15"},/area/space)
"SO" = (/turf/closed/shuttle/dropship1/transparent{icon_state = "26"},/area/space)
"Ta" = (/obj/structure/machinery/door/airlock/dropship_hatch{id = "port_door"},/obj/structure/stairs{dir = 8; icon_state = "ramptop"},/obj/structure/blocker/forcefield/multitile_vehicles,/turf/open/shuttle/dropship{icon_state = "rasputin15"},/area/space)
"Te" = (/turf/closed/shuttle/dropship1{icon_state = "30"},/area/space)
"TO" = (/obj/structure/shuttle/part/dropship1/right_inner_wing_connector,/turf/open/space/basic,/area/space)
"TY" = (/obj/structure/blocker/invisible_wall,/obj/structure/machinery/computer/shuttle/dropship/flight,/turf/open/shuttle/dropship{icon_state = "rasputin15"},/area/space)
"Uf" = (/obj/structure/shuttle/part/dropship1/bottom_right_wall,/turf/open/space/basic,/area/space)
"Uk" = (/turf/closed/shuttle/dropship1{icon_state = "10"},/area/space)
"Ut" = (/obj/structure/stairs,/obj/structure/platform/ship{dir = 4},/turf/open/shuttle/dropship{icon_state = "rasputin15"},/area/space)
"UX" = (/turf/closed/shuttle/dropship1{icon_state = "14"},/area/space)
"Vm" = (/obj/structure/bed/chair/vehicle{dir = 1; pixel_x = 8},/obj/structure/bed/chair/vehicle{dir = 1; pixel_x = -8},/turf/open/shuttle/dropship{icon_state = "rasputin15"},/area/space)
"Vn" = (/turf/closed/shuttle/dropship1/transparent{icon_state = "32"},/area/space)
"VK" = (/obj/structure/shuttle/part/dropship1/bottom_left_wall,/turf/open/space/basic,/area/space)
"Xm" = (/turf/open/shuttle/dropship{icon_state = "rasputin6"},/area/space)
"XD" = (/turf/closed/shuttle/dropship1{icon_state = "73"},/area/space)
"XN" = (/obj/effect/decal/warning_stripes{icon_state = "E"; pixel_x = 1},/turf/open/shuttle/dropship{icon_state = "rasputin3"},/area/space)
"XY" = (/turf/closed/shuttle/dropship1{icon_state = "62"},/area/space)
"Yr" = (/turf/closed/shuttle/dropship1/transparent{icon_state = "98"},/area/space)
"YD" = (/turf/closed/shuttle/dropship1{icon_state = "43"},/area/space)
"YS" = (/turf/closed/shuttle/dropship1/transparent{icon_state = "29"},/area/space)
"Zj" = (/turf/closed/shuttle/dropship1{icon_state = "25"},/area/space)

(1,1,1) = {"
xpxpxphcoJoJoJeMxpxpxp
xpxpxpKYcXJMYrJwxpxpxp
xpxpxpCDQfTYShhxxpxpxp
xpOCitvhPTGgQtwkJCxfxp
xpdkuuIKNZhGJOMHgVoFxp
dUfjGugJXmizrhgJGuXDxX
FFEzVmVmqTJpqTVmQVfiok
wSXYGuGuqTMJqTGuGuPgmA
xpTaMJMJqTJpqTMJMJcMxp
xpTaMJMJqTMJqTicINcMxp
xpQUUtMJqTbFqTJVGsAZxp
xpeVERiLpOGlwwjMgThHxp
xptrUkujvVvXRaEoUkatxp
jPHPFWmLXNkycFfLYDjPHP
wZymFWiuXNMJcFfLYDOUlN
hSYSTemLXNMJcFfLbVVnyc
GzbkkCmLXNMJcFfLZjSOkp
dZQFFWELXNMJcFMxYDdZQF
xpxpVKUkCUMJqhUXUfxpxp
xpxpxpQexpxpxpTOxpxpxp
xpOsISvBxpxpxptXyeBxxp
"}
