"a" = (/turf/open/void/vehicle,/area/space)
"b" = (/obj/structure/interior_wall/van{icon_state = "front_1"},/turf/open/void/vehicle,/area/space)
"c" = (/obj/structure/interior_wall/van{icon_state = "front_3"},/turf/open/void/vehicle,/area/space)
"h" = (/obj/effect/landmark/interior/spawn/entrance{alpha = 50; exit_type = /obj/structure/interior_exit/vehicle/van/right; name = "right entrance marker"; tag = "right"},/obj/structure/bed/chair/comfy{dir = 4; icon_state = "comfychair"},/turf/open/shuttle/vehicle{icon_state = "floor_3_12"},/area/vehicle/van)
"i" = (/obj/structure/interior_wall/van{alpha = 50; icon_state = "exterior_door"; layer = 5.2; pixel_y = 32},/turf/open/void/vehicle,/area/space)
"m" = (/obj/structure/interior_wall/van{icon_state = "back_2"},/turf/open/void/vehicle,/area/space)
"o" = (/obj/effect/landmark/interior/spawn/entrance{dir = 8; exit_type = /obj/structure/interior_exit/vehicle/van/backleft; name = "back left entrance marker"; pixel_x = -32; tag = "back_left"},/obj/structure/machinery/medical_pod/bodyscanner,/turf/open/shuttle/vehicle{icon_state = "floor_1_7"},/area/vehicle/van)
"p" = (/obj/structure/interior_wall/tank,/obj/structure/vehicle_locker/med,/turf/open/void/vehicle,/area/space)
"r" = (/obj/structure/interior_wall/van{icon_state = "front_2"},/turf/open/void/vehicle,/area/space)
"s" = (/obj/structure/interior_wall/tank,/obj/structure/machinery/newscaster/security_unit,/turf/open/void/vehicle,/area/space)
"x" = (/obj/effect/landmark/interior/spawn/interior_viewport/simple{alpha = 100; pixel_y = -2},/obj/structure/surface/rack{density = 0; pixel_y = -2},/turf/open/shuttle/vehicle{icon_state = "floor_1_1"},/area/vehicle/van)
"y" = (/obj/structure/machinery/body_scanconsole{icon = 'icons/obj/structures/machinery/terminals.dmi'; icon_state = "req_comp0"; pixel_y = 6},/obj/structure/bed/portable_surgery,/turf/open/shuttle/vehicle{icon_state = "floor_1_2"},/area/vehicle/van)
"B" = (/obj/structure/interior_wall/tank{alpha = 50; layer = 5.2; pixel_y = 32},/turf/open/void/vehicle,/area/space)
"D" = (/turf/open/shuttle/vehicle{icon_state = "floor_1_1"},/area/vehicle/van)
"H" = (/obj/structure/interior_wall/van{icon_state = "interior_door"},/obj/effect/vehicle_roof/van{icon_state = "front_roof_1"},/obj/effect/landmark/interior/spawn/interior_viewport/simple/windshield,/turf/open/void/vehicle,/area/space)
"M" = (/obj/structure/interior_wall/van{icon_state = "back_3"},/turf/open/void/vehicle,/area/space)
"O" = (/obj/structure/bed/chair/vehicle{layer = 3.5; pixel_x = -8; pixel_y = 12},/obj/structure/bed/chair/vehicle{layer = 3.5; pixel_x = 8; pixel_y = 12},/turf/open/shuttle/vehicle{icon_state = "floor_1_8"},/area/vehicle/van)
"P" = (/obj/structure/interior_wall/tank{layer = 2},/turf/open/void/vehicle,/area/space)
"Q" = (/obj/effect/landmark/interior/spawn/entrance{dir = 1; exit_type = /obj/structure/interior_exit/vehicle/van/left; name = "left entrance marker"; pixel_y = 32; tag = "left"},/obj/effect/landmark/interior/spawn/vehicle_driver_seat{dir = 4},/obj/effect/vehicle_roof/van{icon_state = "front_roof_2"},/obj/effect/landmark/interior/spawn/interior_viewport/simple/windshield{icon_state = "windshield_viewport_bottom"},/turf/open/shuttle/vehicle{icon_state = "floor_3_11"},/area/vehicle/van)
"R" = (/obj/structure/interior_wall/tank,/obj/structure/surface/rack{density = 0; pixel_y = -16},/turf/open/void/vehicle,/area/space)
"U" = (/obj/effect/landmark/interior/spawn/interior_viewport/simple{pixel_y = 30},/turf/open/shuttle/vehicle{icon_state = "floor_1_2"},/area/vehicle/van)
"V" = (/obj/structure/interior_wall/van{icon_state = "back_1"},/turf/open/void/vehicle,/area/space)
"X" = (/obj/structure/bed/chair/vehicle{dir = 1; pixel_x = -8},/obj/structure/bed/chair/vehicle{dir = 1; pixel_x = 8},/turf/open/shuttle/vehicle{icon_state = "floor_1_9"},/area/vehicle/van)
"Z" = (/obj/effect/landmark/interior/spawn/entrance{dir = 8; exit_type = /obj/structure/interior_exit/vehicle/van/backright; name = "back right entrance marker"; pixel_x = -32; tag = "back_right"},/turf/open/shuttle/vehicle{icon_state = "floor_1_10"},/area/vehicle/van)

(1,1,1) = {"
MpPRsHc
moyUOQr
VZDxXhb
aBBBBia
"}
